tracks/road/g-track-1/g-track-1.xml	road	g-track-1
tracks/road/g-track-2/g-track-2.xml	road	g-track-2
tracks/road/g-track-3/g-track-3.xml	road	g-track-3
tracks/road/ole-road-1/ole-road-1.xml	road	ole-road-1
tracks/road/ruudskogen/ruudskogen.xml	road	ruudskogen
tracks/road/spring/spring.xml	road	spring
tracks/road/street-1/street-1.xml	road	street-1
tracks/road/wheel-1/wheel-1.xml	road	wheel-1
tracks/road/wheel-2/wheel-2.xml	road	wheel-2
tracks/road/aalborg/aalborg.xml	road	aalborg
tracks/road/alpine-1/alpine-1.xml	road	alpine-1
tracks/road/alpine-2/alpine-2.xml	road	alpine-2
tracks/road/brondehach/brondehach.xml	road	brondehach
tracks/road/corkscrew/corkscrew.xml	road	corkscrew
tracks/road/e-track-1/e-track-1.xml	road	e-track-1
tracks/road/e-track-2/e-track-2.xml	road	e-track-2
tracks/road/e-track-3/e-track-3.xml	road	e-track-3
tracks/road/e-track-4/e-track-4.xml	road	e-track-4
tracks/road/e-track-6/e-track-6.xml	road	e-track-6
tracks/road/eroad/eroad.xml	road	eroad
tracks/road/forza/forza.xml	road	forza
tracks/dirt/mixed-2/mixed-2.xml	dirt	mixed-2
tracks/dirt/dirt-1/dirt-1.xml	dirt	dirt-1
tracks/dirt/dirt-2/dirt-2.xml	dirt	dirt-2
tracks/dirt/dirt-3/dirt-3.xml	dirt	dirt-3
tracks/dirt/dirt-4/dirt-4.xml	dirt	dirt-4
tracks/dirt/dirt-5/dirt-5.xml	dirt	dirt-5
tracks/dirt/dirt-6/dirt-6.xml	dirt	dirt-6
tracks/dirt/mixed-1/mixed-1.xml	dirt	mixed-1
tracks/oval/d-speedway/d-speedway.xml	oval	d-speedway
tracks/oval/e-speedway/e-speedway.xml	oval	e-speedway
tracks/oval/e-track-5/e-track-5.xml	oval	e-track-5
tracks/oval/f-speedway/f-speedway.xml	oval	f-speedway
tracks/oval/g-speedway/g-speedway.xml	oval	g-speedway
tracks/oval/michigan/michigan.xml	oval	michigan
tracks/oval/a-speedway/a-speedway.xml	oval	a-speedway
tracks/oval/b-speedway/b-speedway.xml	oval	b-speedway
tracks/oval/c-speedway/c-speedway.xml	oval	c-speedway
